ARDUINO_LORAWAN_PRINTF	KEYWORD2
Arduino_LoRaWAN	KEYWORD1
cLMIC	KEYWORD1
LOG_BASIC	LITERAL1
LOG_ERRORS	LITERAL1
LOG_VERBOSE	LITERAL1
kNone	LITERAL1
kAbp	LITERAL1
kOTAA	LITERAL1
AbpProvisioningInfo	KEYWORD1
OtaaProvisioningInfo	KEYWORD1
ProvisioningInfo	KEYWORD1
begin	KEYWORD2
loop	KEYWORD2
RegisterListener	KEYWORD2
DispatchEvent	KEYWORD2
GetDebugMask	KEYWORD2
SetDebugMask	KEYWORD2
LogPrintf	KEYWORD2
GetInstance	KEYWORD2
GetTxReady	KEYWORD2
SendBuffer	KEYWORD2
GetDevEUI	KEYWORD2
GetAppEUI	KEYWORD2
GetAppKey	KEYWORD2
Arduino_LoRaWAN_ttn_base	KEYWORD1
Arduino_LoRaWAN_ttn_eu868	KEYWORD1
Arduino_LoRaWAN_ttn_as923	KEYWORD1
Arduino_LoRaWAN_ttn_us915	KEYWORD1
Arduino_LoRaWAN_REGION_TAG	LITERAL1
